S -> DGL
DGL -> DG | DG DGL
DG -> DGSSIG | DGMSIG
DGSSIG -> DGN | DGN DGRM | DGLM DGN | DGLM DGN DGRM 
DGN -> DIN | DBN | DSCDC | DSCDF | DSCD | DPN
DGLM -> DOSEFORM | FREQ | RUT| DRT | MDBN | NEC
DGRM -> SSIG PRD | SSIG | PRD 
PRD -> NEC | REFL | DISA | NEC REFL | REFL NEC | PRN DISA | DISA NEC | REFL DISA | DISA REFL | NEC REFL DISA | NEC DISA REFL | REFL NEC DISA | REFL DISA NEC | DISA NEC REFL | DISA REFL NEC  
SSIG -> DOSEFORM RUT FREQTOD DRT | DOSEFORM FREQTOD RUT RUT | DOSEFORM RUT FREQTOD | DOSEFORM FREQTOD RUT | DOSEFORM RUT DRT | DOSEFORM FREQTOD DRT | RUT FREQTOD DRT | FREQTOD RUT DRT | DOSEFORM RUT | DOSEFORM FREQTOD | DOSEFORM DRT |  RUT FREQTOD | FREQTOD RUT | RUT DRT | FREQTOD DRT | DOSEFORM | RUT | FREQTOD | DRT | MDBN
SSIG -> DOSEFORM DOSEAMT RUT FREQTOD DRT | DOSEFORM DOSEAMT FREQTOD RUT RUT | DOSEFORM DOSEAMT RUT FREQTOD | DOSEFORM DOSEAMT FREQTOD RUT | DOSEFORM DOSEAMT RUT DRT | DOSEFORM DOSEAMT FREQTOD DRT | DOSEAMT RUT FREQTOD DRT | DOSEAMT FREQTOD RUT DRT | DOSEFORM DOSEAMT RUT | DOSEFORM DOSEAMT FREQTOD | DOSEAMT RUT FREQTOD | DOSEAMT FREQTOD RUT | DOSEAMT RUT DRT | DOSEAMT FREQTOD DRT | DOSEAMT FREQTOD | DOSEAMT
SSIG -> DOSEFORM MDBN RUT FREQTOD DRT | DOSEFORM MDBN FREQTOD RUT RUT | DOSEFORM MBDN RUT FREQTOD | DOSEFORM MDBN FREQTOD RUT | DOSEFORM MDBN RUT DRT | DOSEFORM MDBN FREQTOD DRT | DOSEFORM MDBN RUT | DOSEFORM MDBN FREQTOD | DOSEFORM MDBN DRT | DOSEFORM MDBN | DOSEFORM MDBN MDBN RUT FREQTOD DRT | DOSEFORM MDBN MDBN FREQTOD RUT RUT | DOSEFORM MBDN MDBN RUT FREQTOD | DOSEFORM MDBN MDBN FREQTOD RUT | DOSEFORM MDBN MDBN RUT DRT | DOSEFORM MDBN MDBN FREQTOD DRT | DOSEFORM MDBN MDBN RUT | DOSEFORM MDBN MDBN FREQTOD | DOSEFORM MDBN MDBN DRT | DOSEFORM MDBN MDBN | DOSEFORM MDBN RUT FREQTOD
SSIG -> DOSEFORM MDBN DOSEAMT RUT FREQTOD DRT | DOSEFORM MDBN DOSEAMT FREQTOD RUT RUT | DOSEFORM MDBN DOSEAMT RUT FREQTOD | DOSEFORM MDBN DOSEAMT FREQTOD RUT | DOSEFORM MDBN DOSEAMT RUT DRT | DOSEFORM MDBN DOSEAMT FREQTOD DRT | DOSEFORM MDBN DOSEAMT RUT | DOSEFORM MDBN DOSEAMT FREQTOD | DOSEFORM MDBN MDBN DOSEAMT RUT FREQTOD DRT | DOSEFORM MDBN MDBN DOSEAMT FREQTOD RUT RUT | DOSEFORM MDBN MDBN DOSEAMT RUT FREQTOD | DOSEFORM MDBN MDBN DOSEAMT FREQTOD RUT | DOSEFORM MDBN MDBN DOSEAMT RUT DRT | DOSEFORM MDBN MDBN DOSEAMT FREQTOD DRT | DOSEFORM MDBN MDBN DOSEAMT RUT | DOSEFORM MDBN MDBN DOSEAMT FREQTOD | MDBN | MDBN MDBN | DOSEFORM MDBN DOSE RUT FREQ | DOSEFORM MDBN DOSE RUT FREQ TOD | DOSEFORM MDBN DOSE RUT FREQ TOD TOD| MDBN MDBN DOSEFORM DOSEAMT
SSIG -> MDBN DOSEFORM RUT FREQTOD DRT | MDBN DOSEFORM FREQTOD RUT RUT | MDBN DOSEFORM RUT FREQTOD | MDBN DOSEFORM FREQTOD RUT | MDBN DOSEFORM RUT DRT | MDBN DOSEFORM FREQTOD DRT | MDBN DOSEFORM RUT | MDBN DOSEFORM FREQTOD | MDBN DOSEFORM DRT | MDBN DOSEFORM RUT FREQTOD | MDBN MDBN DOSEFORM RUT | MDBN MDBN DOSEFORM FREQ RUT | MDBN DOSEFORM FREQ RUT | DDF MDBN DOSEFORM RUT FREQTOD | MDBN MDBN DOSEFORM FREQTOD | MDBN MDBN DOSEFORM FREQTOD DOSE FREQ | MDBN MDBN DOSEFORM FREQTOD DOSE FREQ TOD | MDBN MDBN DOSEFORM RUT FREQTOD |  MDBN MDBN DOSEFORM DOSEAMT RUT FREQTOD | MDBN DOSEFORM DOSEAMT RUT FREQTOD TOD TOD | MDBN MDBN DOSEFORM RUT FREQTOD TOD TOD
SSIG -> MDBN DOSEFORM DOSEAMT RUT FREQTOD DRT | MDBN DOSEFORM DOSEAMT FREQTOD RUT RUT | MDBN DOSEFORM DOSEAMT RUT FREQTOD | MDBN DOSEFORM DOSEAMT FREQTOD RUT | MDBN DOSEFORM DOSEAMT RUT DRT | MDBN DOSEFORM DOSEAMT FREQTOD DRT | MDBN DOSEFORM DOSEAMT RUT | MDBN DOSEFORM DOSEAMT FREQTOD | MDBN DOSEFORM MDBN DOSEAMT RUT FREQTOD DRT | MDBN DOSEFORM RUT FREQTOD FREQTOD | MDBN DOSEFORM | MDBN DOSEFORM FREQTOD DOSEFORM FREQTOD
SSIG -> DDF MDBN DOSE DOSEAMT RUT FREQ | DDF MDBN DOSE RUT FREQ | DDF DOSEFORM MDBN DOSEFORM RUT FREQTOD FREQTOD | DDF DOSEFORM MDBN DOSEAMOUNT RUT FREQTOD FREQTOD | DDF DOSEFORM MDBN DOSEAMT RUT FREQTOD TOD TOD 
DOSEFORM -> DOSE | DDF | DOSE DDF | DDF DOSE
FREQTOD -> FREQ TOD | FREQ | TOD 
DGMSIG -> DGN SIGL | DGN DOSEFORM SIGL |  DGN DOSEFORM RUT SIGL | DGN DOSEFORM SIGL RUT | DGN SIGL PRD | DGN DOSEFORM SIGL PRD | DGN DOSEFORM RUT SIGL PRD | DGN DOSEFORM SIGL RUT PRD 
SIGL -> ANDSIGL | THENSIGL
ANDSIGL -> ANDSIG ANDSIG | ANDSIG ANDSIGL
ANDSIG -> DOSE RUT FREQTOD | DOSE FREQTOD RUT | DOSE FREQTOD | DOSEAMT FREQTOD | DOSEAMT RUT | DOSEAMT RUT FREQTOD | DOSEAMT FREQTOD RUT | DRT FREQTOD
THENSIGL -> THENSIG THENSIG | THENSIG THENSIGL 
THENSIG -> DOSE RUT FREQTOD DRT | DOSE RUT DRT |RUT DOSE DRT | DOSE FREQTOD DRT | FREQTOD DOSE DRT | RUT FREQTOD DRT | FREQTOD RUT DRT | DOSE DRT | FREQTOD DRT | DOSEAMT RUT FREQTOD DRT | DOSEAMT RUT DRT | DOSEAMT FREQTOD DRT | DOSEAMT DRT 
DOSE -> 'sDOSE'
DRT -> 'sDRT'
DOSEAMT -> 'sDOSEAMT'
DIN -> 'sDIN'
DBN -> 'sDBN'
DDF -> 'sDDF'
NEC -> 'sNEC'
REFL -> 'sREFL'
DISA -> 'sDISA'
RUT -> 'sRUT'
FREQ -> 'sFREQ'
TOD -> 'sTOD'
DSCDC -> 'sDSCDC'
DSCDF -> 'sDSCDF'
DSCD -> 'sDSCD'
DSBD -> 'sDSBD'
DSBDC -> 'sDSBDC'
DSBDF -> 'sDSBDF'
DPN -> 'sDPN'
MDBN -> 'sMDBN'
INDICATION -> 'sINDICATION'